x,x,x,x,x,x,x,x,x,x,x,x
x,x,x,x,x,x,x,x,x,x,x,x
x,x,x,x,x,x,x,x,x,x,x,x
x,x,x,x,-,u,-,-,x,x,x,x
x,x,x,-,-,w,-,-,x,x,x,x
x,x,x,-,w,w,w,-,-,x,x,x
x,x,-,-,w,w,w,-,-,x,x,x
x,x,-,-,-,w,-,-,-,x,x,x
x,x,s,-,-,-,-,s,x,x,x,x
x,x,-,-,-,-,-,x,x,x,x,x
x,x,-,-,x,x,-,x,x,x,x,x
x,-,-,x,x,x,x,x,x,x,x,x
