x,x,x,x,x,-,x,x,x,x,x,x
x,x,x,x,x,-,x,x,x,x,x,x
x,x,x,x,-,g,-,x,x,x,x,x
x,x,x,-,-,-,-,-,x,x,x,x
x,x,-,s,-,-,-,-,s,x,x,x
-,g,-,g,-,g,-,-,-,-,-,-
-,-,-,-,b,-,-,g,-,-,-,-
x,x,g,-,-,t,-,-,-,x,x,x
x,x,x,s,-,g,-,-,x,x,x,x
x,x,x,x,-,-,s,x,x,x,x,x
x,x,x,x,x,-,x,x,x,x,x,x
x,x,x,x,x,-,x,x,x,x,x,x
