x,x,x,x,x,x,x,x,x,x,x,x
x,x,x,x,x,x,x,x,x,x,x,x
x,x,x,x,x,x,x,x,x,x,x,x
x,x,x,x,x,x,x,x,x,x,x,x
x,x,x,x,x,x,x,x,s,x,x,x
-,x,-,g,x,x,x,x,x,x,x,x
-,-,g,-,g,x,x,x,x,x,x,x
x,x,x,-,-,x,x,x,x,x,x,x
x,x,x,x,-,x,x,x,x,x,x,x
x,x,x,x,-,g,x,x,x,x,x,x
x,x,x,x,x,-,x,x,x,x,x,x
x,x,x,x,x,-,x,x,x,x,x,x
