w,w,w,w,w,w,w,w,w,w,w,w
w,w,w,w,w,w,w,w,-,g,w,w
w,w,w,w,-,g,w,w,-,-,w,g
w,w,w,-,-,w,w,w,g,-,w,g
w,w,g,-,-,-,-,T,g,g,g,g
w,w,-,-,w,-,w,-,T,w,T,T
w,w,-,-,-,-,w,-,T,T,T,T
w,w,-,-,w,-,-,T,T,T,T,w
w,w,g,-,-,-,T,g,g,g,w,w
w,w,w,w,-,-,w,-,w,w,g,w
w,w,w,w,-,w,w,w,w,w,w,w
w,w,w,w,-,w,w,w,w,w,w,w
