w,w,w,w,w,w,w,w,w,w,w,w
w,w,w,w,w,w,w,w,-,g,w,w
w,w,w,w,-,g,w,w,-,-,w,g
w,w,w,-,-,w,w,w,w,-,w,w
w,w,g,-,-,-,-,w,w,w,w,w
w,w,-,-,w,-,w,-,w,w,w,g
w,w,-,-,-,-,w,-,w,w,w,w
w,w,-,-,w,-,-,w,w,-,w,w
w,w,g,-,-,-,w,w,w,w,w,w
w,w,w,w,-,-,w,-,w,w,g,w
w,w,w,w,-,w,w,w,w,w,w,w
w,w,w,w,-,w,w,w,w,w,w,w
