x,x,x,x,x,x,x,x,x,x,x,x
x,x,x,x,x,x,x,x,x,x,x,x
x,x,x,x,x,x,x,x,x,x,x,x
x,x,x,x,x,x,x,x,x,x,x,x
x,x,x,-,-,-,x,x,x,x,x,x
x,x,x,-,u,-,x,x,x,x,x,x
x,x,x,-,-,-,x,x,x,x,x,x
x,x,-,-,t,x,x,x,x,x,x,x
x,x,-,x,x,x,x,x,x,x,x,x
x,x,-,x,x,x,x,x,x,x,x,x
x,x,-,-,x,x,x,x,x,x,x,x
x,x,-,-,x,x,x,x,x,x,x,x
