w,w,w,w,-,w,w,w,w,w,w,w
w,w,w,-,-,w,w,w,w,w,w,w
w,w,w,-,T,-,w,w,w,w,w,w
w,w,g,-,-,g,-,w,w,w,w,w
w,w,-,-,-,-,-,N,w,w,w,w
w,-,T,-,d,-,H,-,w,w,w,w
w,-,-,-,-,-,g,-,w,w,w,w
w,w,g,-,T,-,-,w,w,w,w,w
w,w,w,-,-,g,w,w,w,w,w,w
w,w,w,w,w,w,w,w,w,w,w,w
w,w,w,w,w,w,w,w,w,w,w,w
w,w,w,w,w,w,w,w,w,w,w,w
