w,w,w,w,w,w,w,w,w,w,w,w
w,w,-,w,w,-,-,w,w,w,w,w
w,w,-,-,-,-,-,w,w,w,w,-
w,w,w,-,-,-,-,-,w,w,-,-
w,w,w,-,-,-,-,H,-,-,-,-
w,w,P,-,-,-,g,-,N,-,-,-
w,w,w,-,-,-,-,-,-,-,g,-
w,w,w,-,-,-,-,-,g,-,-,-
w,w,w,-,g,-,-,-,-,-,-,-
w,w,-,-,-,-,-,-,-,-,-,g
w,w,-,-,-,-,T,-,-,T,-,-
w,w,-,g,-,-,-,-,-,-,-,-
