w,w,w,w,w,w,w,w,w,w,w,w
w,w,-,w,w,-,-,w,w,w,w,w
w,w,-,-,-,-,-,w,w,w,w,-
w,w,w,-,-,-,-,-,w,w,-,-
w,w,-,-,-,-,-,H,-,-,-,-
w,w,-,-,-,-,g,-,N,-,-,-
w,w,-,-,-,-,-,-,-,-,g,-
w,w,w,-,-,-,-,-,g,-,-,-
w,w,w,-,g,-,-,-,-,-,-,-
w,w,-,-,-,-,-,-,-,-,-,g
w,w,-,-,-,-,T,-,-,T,-,-
w,w,-,g,-,-,-,-,-,-,-,-
