w,w,w,w,w,w,w,w
w,w,-,w,w,-,-,w
w,w,-,-,-,-,-,w
w,w,w,-,-,-,-,-
w,w,w,-,-,-,-,H
w,w,P,-,-,-,g,-
w,w,w,-,-,-,-,-
w,w,w,-,-,-,-,-
