w,w,w,w,w,w,w,w,w,w,w,w
w,w,-,w,g,-,-,g,w,w,w,w
w,w,-,-,-,-,-,w,w,w,g,-
w,g,w,-,-,-,-,-,w,w,-,-
w,T,-,-,-,-,-,H,-,-,-,-
T,T,-,-,-,-,g,-,N,-,-,-
T,T,-,-,-,-,-,-,-,-,g,-
T,T,w,-,-,-,-,-,g,-,-,-
g,T,w,-,g,-,-,-,-,-,-,-
w,T,-,-,-,-,-,-,-,-,-,g
w,g,-,-,-,-,T,-,-,T,-,-
w,w,-,g,-,-,-,-,-,-,-,-
