w,w,-,-,-,-,-,-,-,-,-,g
w,w,-,-,-,-,T,-,-,T,-,-
w,w,-,g,-,-,-,-,-,-,-,-
w,w,-,-,-,-,-,w,w,w,w,-
w,w,w,-,-,-,-,g,-,-,-,-
w,w,-,-,-,-,g,-,g,-,-,-
w,w,-,-,-,-,-,-,-,-,g,-
w,w,-,-,-,s,-,-,w,w,-,-
w,w,w,-,-,-,-,-,g,-,-,-
w,w,w,-,g,-,-,-,-,-,-,-
w,w,-,w,w,-,-,w,w,w,w,w
w,w,w,w,w,w,w,w,w,w,w,w
