x,x,x,x,x,x,x,x,x,x,x,x
x,x,x,x,x,x,x,x,x,x,x,x
x,x,x,x,x,x,x,x,x,x,x,x
x,x,x,x,-,u,-,-,x,x,x,x
x,x,x,-,b,w,s,-,x,x,x,x
x,x,x,-,w,w,w,-,-,x,x,x
x,x,-,-,w,w,w,-,-,x,x,x
x,x,-,-,-,w,-,-,-,x,x,x
x,x,-,-,-,-,-,s,x,x,x,x
x,x,-,-,-,-,-,x,x,x,x,x
x,x,-,-,x,x,-,x,x,x,x,x
x,-,-,x,x,x,x,x,x,x,x,x
