x,-,-,x,x,x,x,x,x,x,x,x
x,-,-,x,x,x,x,x,x,x,x,x
x,x,-,-,-,x,x,x,x,x,x,x
x,-,-,x,x,x,x,x,x,x,x,x
x,x,-,-,s,x,x,x,x,x,x,x
x,x,x,-,-,-,x,x,-,-,-,-
x,x,-,-,-,x,x,-,-,-,-,-
x,-,-,-,x,x,-,-,-,x,x,x
x,x,b,-,-,x,-,s,x,x,x,x
x,x,x,-,-,-,-,x,x,x,x,x
x,x,x,-,x,x,-,x,x,x,x,x
x,x,x,x,x,x,x,x,x,x,x,x
