x,x,x,x,x,x,x,x,x,x,x,x
x,x,x,x,x,x,x,x,x,x,x,x
x,x,x,x,x,x,x,x,x,x,x,x
x,x,x,-,-,-,-,-,-,x,x,x
x,x,x,-,-,-,-,-,-,-,x,x
x,x,x,-,g,-,-,-,-,s,x,x
x,x,x,x,x,-,-,u,-,-,-,-
x,x,x,x,-,-,-,-,g,-,x,x
x,x,x,x,-,x,x,x,x,x,x,x
x,x,x,x,x,x,x,x,x,x,x,x
x,x,x,x,x,x,x,x,x,x,x,x
x,x,x,x,x,x,x,x,x,x,x,x
