x,x,x,x,x,x,x,x,x,x,x,x
x,x,x,x,x,x,x,x,x,x,x,x
x,x,x,x,x,x,x,x,x,x,x,x
x,x,x,-,-,-,-,-,-,x,x,x
x,x,x,-,H,-,-,-,s,-,x,x
x,x,x,-,g,x,x,-,-,-,x,x
x,x,x,x,-,-,x,-,-,s,-,-
x,x,x,x,u,-,x,-,g,-,x,x
x,x,x,x,-,x,x,x,x,x,x,x
x,x,x,x,x,x,x,x,x,x,x,x
x,x,x,x,x,x,x,x,x,x,x,x
x,x,x,x,x,x,x,x,x,x,x,x
