x,x,x,x,x,x,x,x,x,x,x,x
x,x,x,x,x,x,x,x,x,x,x,x
x,x,x,x,x,x,x,x,x,x,x,x
x,x,x,-,-,-,-,-,t,x,x,x
x,x,x,-,-,-,g,-,s,-,x,x
x,x,x,-,g,x,x,-,-,-,x,x
x,x,x,x,-,t,x,-,-,s,-,-
x,x,x,x,u,-,x,-,g,-,x,x
x,x,x,x,-,x,x,x,x,x,x,x
x,x,x,x,x,x,x,x,x,x,x,x
x,x,x,x,x,x,x,x,x,x,x,x
x,x,x,x,x,x,x,x,x,x,x,x
