x,x,x,x,x,x,x,x,x,x,x,x
x,x,x,x,x,x,x,x,x,x,x,x
x,x,x,x,x,x,x,x,x,x,x,x
x,x,x,x,x,x,x,x,x,x,x,x
x,x,x,x,-,-,-,x,x,x,x,x
x,-,-,-,-,u,-,-,x,x,x,x
x,-,w,w,-,-,-,-,x,x,x,x
x,g,w,w,x,x,x,x,x,x,x,x
x,-,f,g,-,x,x,x,x,x,x,x
x,-,g,-,-,x,x,x,x,x,x,x
x,-,-,-,x,x,x,x,x,x,x,x
x,x,x,x,x,x,x,x,x,x,x,x
