x,x,x,x,x,x,x,x,x,x,x,x
x,x,x,x,x,x,x,x,x,x,x,x
x,x,x,x,-,x,-,x,x,x,x,x
x,x,x,-,-,-,-,-,x,x,x,x
x,x,x,x,-,-,-,x,x,x,-,-
x,x,x,x,-,d,-,-,-,-,-,x
x,x,x,-,-,-,-,-,-,-,x,x
x,x,x,-,-,x,x,-,x,x,x,x
x,x,x,x,-,-,-,-,x,x,x,x
x,x,x,x,-,-,x,x,x,x,x,x
x,x,x,x,x,-,x,x,x,x,x,x
x,x,x,x,x,x,x,x,x,x,x,x
