x,x,x,x,x,-,x,x,x,x,x,x
x,x,x,x,x,-,x,x,x,x,x,x
x,x,x,x,-,g,-,x,x,x,x,x
x,x,x,-,-,-,-,-,x,x,x,x
x,x,-,s,-,-,-,-,-,x,x,x
-,g,-,g,-,g,-,-,-,s,-,-
-,-,-,-,b,-,-,g,-,-,-,-
x,x,g,-,-,-,-,-,-,x,x,x
x,x,x,s,-,g,-,-,x,x,x,x
x,x,x,x,-,-,s,x,x,x,x,x
x,x,x,x,x,-,x,x,x,x,x,x
x,x,x,x,x,-,x,x,x,x,x,x
