x,x,x,-,x,x,x,x,x,x,x,x
x,x,-,-,x,x,x,x,x,x,x,x
x,g,-,-,-,x,x,x,x,x,x,x
x,-,-,-,b,x,x,x,x,x,x,x
-,-,-,x,x,x,x,x,x,x,x,x
x,x,x,x,x,x,x,x,x,x,x,x
x,x,x,x,x,x,x,x,x,x,x,x
x,x,x,x,x,x,x,x,x,x,x,x
x,x,x,x,x,x,x,x,x,x,x,x
x,x,x,x,x,x,x,x,x,x,x,x
x,x,x,x,x,x,x,x,x,x,x,x
x,x,x,x,x,x,x,x,x,x,x,x
