w,w,w,w,w,w,w,w,w,w,w,w
w,w,w,w,w,w,w,w,g,-,w,w
w,w,w,w,g,-,w,w,g,g,w,-
w,w,w,g,g,w,w,w,-,g,w,-
w,w,-,g,g,g,g,T,-,-,-,-
w,w,g,g,w,g,w,g,T,w,T,T
w,w,g,g,g,g,w,g,T,T,T,T
w,w,g,g,w,g,g,T,T,T,T,w
w,w,-,g,g,g,T,-,-,-,w,w
w,w,w,w,g,g,w,g,w,w,-,w
w,w,w,w,g,w,w,w,w,w,w,w
w,w,w,w,g,w,w,w,w,w,w,w
