w,w,w,w,g,w,w,w,w,w,w,w
w,w,w,g,g,w,w,w,w,w,w,w
w,w,w,g,T,g,w,w,w,w,w,w
w,w,-,g,g,-,g,w,w,w,w,w
w,w,g,g,g,g,g,N,w,w,w,w
w,g,T,g,d,g,H,g,w,w,w,w
w,g,g,g,g,g,-,g,w,w,w,w
w,w,-,g,T,g,g,w,w,w,w,w
w,w,w,g,g,-,w,w,w,w,w,w
w,w,w,w,w,w,w,w,w,w,w,w
w,w,w,w,w,w,w,w,w,w,w,w
w,w,w,w,w,w,w,w,w,w,w,w
