w,w,w,w,w,w,w,w,w,w,w,w
w,w,g,w,-,g,g,-,w,w,w,w
w,w,g,g,g,g,g,w,w,w,-,g
w,-,w,g,g,g,g,g,w,w,g,g
w,T,g,g,g,g,-,H,-,g,g,g
T,T,g,g,g,g,-,-,N,g,g,g
T,T,g,g,g,g,-,-,-,g,T,g
T,T,w,g,g,g,g,g,-,-,g,-
-,T,w,g,g,g,g,g,g,g,-,g
w,T,g,`,g,g,g,g,g,g,T,T
w,-,g,g,g,g,T,-,g,T,g,g
w,w,g,g,g,g,-,-,g,g,g,g
