w,w,g,g,g,-,g,g,g,g,g,-
w,w,g,g,-,g,T,g,g,T,g,g
w,w,g,-,g,-,g,g,g,g,w,w
w,w,g,g,-,-,g,w,w,w,w,w
w,w,w,g,g,-,g,-,g,g,w,w
w,w,T,g,-,T,-,g,-,g,w,w
w,T,g,g,-,g,T,g,T,g,-,w
w,T,g,g,g,s,T,g,w,w,g,w
w,w,g,g,g,f,-,g,T,g,g,w
w,g,w,f,g,-,g,g,g,g,w,w
w,w,g,g,f,g,g,w,w,w,w,w
w,w,w,w,w,w,w,w,w,w,w,w
