w,w,w,w,w,w,w,w,w,w,w,w
w,w,-,w,w,-,-,w,w,w,w,w
-,-,-,-,-,g,-,w,w,w,w,w
-,-,-,-,-,-,-,w,w,w,w,w
-,-,g,T,-,w,w,w,-,-,w,w
-,-,-,-,-,w,w,-,w,-,w,w
-,-,-,-,g,-,-,-,-,-,w,w
-,-,-,-,-,-,-,g,w,g,w,w
-,-,-,-,g,-,T,-,-,-,w,w
-,-,T,-,-,-,-,-,-,-,w,w
-,-,-,-,-,-,w,w,w,w,w,w
-,w,w,w,w,w,w,w,w,w,w,w
