w,w,w,w,w,w,w,w,w,w,w,w
w,w,g,w,w,g,g,w,w,w,w,w
g,g,g,g,g,-,g,w,w,w,w,w
g,g,g,g,g,g,g,w,w,w,w,w
g,g,-,T,g,w,w,w,g,g,w,w
T,T,g,g,g,w,w,g,w,g,w,w
g,T,g,g,-,g,g,g,g,g,w,w
-,-,-,g,g,g,g,-,w,-,w,w
T,-,g,-,-,g,T,g,g,g,w,w
g,g,T,g,-,g,g,g,g,g,w,w
g,g,g,g,g,-,g,g,w,w,w,w
g,g,g,g,-,-,g,g,w,w,w,w
