g,g,g,g,g,-,g,g,g,w,w,w
w,w,g,g,g,-,-,g,g,w,w,w
w,w,-,T,g,-,-,g,g,g,w,w
w,w,g,g,g,-,-,g,w,g,w,w
w,w,g,g,T,g,g,g,g,w,w,w
w,w,g,g,T,T,T,g,g,g,w,w
w,w,T,g,g,g,T,g,g,g,w,w
w,w,w,g,d,g,g,g,g,g,w,w
w,w,w,g,g,g,w,w,w,w,w,w
w,w,w,w,w,w,w,w,w,w,w,w
w,w,w,w,w,w,w,w,w,w,w,w
w,w,w,w,w,w,w,w,w,w,w,w
