-,w,w,w,w,w,w,w,w,w,w,w
-,-,-,-,-,g,-,w,w,w,w,w
-,-,g,T,-,w,w,w,-,-,w,w
-,-,-,-,-,w,w,-,w,-,w,w
-,-,-,-,-,-,-,w,w,w,w,w
-,-,-,-,g,-,-,-,-,-,w,w
-,-,-,-,g,-,T,-,-,-,w,w
-,-,-,-,d,-,-,-,-,-,w,w
w,w,w,w,w,w,w,w,w,w,w,w
w,w,w,w,w,w,w,w,w,w,w,w
w,w,w,w,w,w,w,w,w,w,w,w
w,w,w,w,w,w,w,w,w,w,w,w
